Test Maze #1
11 15
l----t--------r
S    i        i
f--- i l----- i
i      i      i
f----- i -----7
i      i      i
i -----x----- i
i      i      i
f----- i -----7
i      i      E
k------^------z

