Test Maze #7
9 10
l--------r
S        i
i ------ i
i        i
i ------ i
i        i
i ------ i
i        E
k--------z

