Test Maze #6
11 11
l-t-------r
S i       i
i i l---- i
i   i     i
i l-^- ---7
i i       i
i i l---- i
i   i     i
f---z ----7
i         E
k---------z

