Test Maze #3
15 40
l----t-------t-------------------------r
S    i       i               i         i
f--- i ----r f------ l---r i i l------ i
i    i     i i       i   i i i i       i
i ---x---- i i ----r i i i i i i ------7
i    i   i i i     i i i i i i i       i
f--- i l i i f---r i i i i i i f------ i
i    i i i i i   i i i i   i i i       i
i ---7 i i i i i i i i i i i i i ------7
i    i i i i i i i i i i i i i i       i
f--- i i i i i i i i i i i i i f------ i
i    i i i i i i i i i i i i i i       i
i ---z i i i i i i i i i i i i i ------7
i      i   i   i   i   i   i   i       E
k------^---^---^---^---^---^---^-------z

